BC5+Scripted_0
[160 100 160 140 120 160 120 140 120 160 120  40  80 100 140 160 120 120
 160 160 120 160 120 140 140 160 100 100 100 140 140 160 120 140 120 160
  60  80 160 140 140 160 120 100 120 120 100 140 120 100 140  80  60 120
 140 160 100  80 140 120 160 120 120 120 120 140 120 140 160 160  60 120
 160 140 140  80 140 160 120 140 140 160 120 140  40 120 140  80 160 160
 140 180 160 140 160 140 140  20 140 100]

BC5+Scripted_1
[160 160 140  80  20  40 120 160 120 120 160 100 100 160 120 120 160 140
 140 120 120 140  80 140 160 120  20 140 160 140 120 140 140 140  80 140
 100 100 120  80 120 160  40 140 140 120 160 120 160 100 120 180  80 140
 140 140 140 120 120 160 160 160  60 140   0 120 120 140 160 140 120 160
 140 140  20 160  40  80  20 160 160 140  80 100 160 100 140 160 100 140
 140 120 140 160 140 160 120 100 140   0]

