BC5+PPO_0
[ 20  20  40  20  40  60  40  20   0   0 100  60   0 140  20 120  40  20
  60  20  40  20   0  60   0 140  20  60   0  20  80   0   0  60   0  40
  40   0  60  40  20   0   0  80 120  20   0  40  40  40  20   0   0 100
   0  20  60 120  40  80  40  40  40  40  60 120   0  20  40   0 100  20
  40  60   0  20  80  40  20 100  20   0  40  40 100  20 120  40  40   0
   0  40   0  20   0  60  80  80  40  20]

BC5+PPO_1
[ 40   0   0  20   0   0  20  20   0   0   0  40  40  40   0   0  20   0
   0  60  20  80   0  20   0  20   0  20  60   0   0   0   0  20   0  80
   0   0  20   0  20  20   0   0   0   0   0   0  40  60   0  20   0   0
  20  40  60   0  60  40 100  40   0   0  20   0   0   0   0  20   0  20
   0   0   0   0  20 120  20  20   0   0  20  40 140  80   0   0  20   0
  20  20   0  80  40   0   0 100  80   0]

