BC5+H_proxy_0
[100 100 100  80  80  80  80  80  80  80 100 100  60  80  80 100 100  80
 100  80 100 100  80 100  80  80  80  60  80 100 100  80 100 100  80  80
  80 100 100  80 100  60 100  80  80  60 100  80  80 120  80  80  80 100
  60 100  60   0 100  60  80 100 100  40 100  80 100 100  80 100 100  60
 100  80 100 120  80  80 100  80 100  80 100  80 100  20  80  80  80 100
  80 100  60  80 100 100 100 100  60 100]

BC5+H_proxy_1
[ 80  20  40  80  80  60  60 120 100  80  80  80  80 100  20  80  80 100
  60  80 100  60 120 100 100  80  80  60 100  80  60 100 100 100  60  80
 100  60 100  80 100 100  40  60  80  80  80  80 100 100 100  60 100  80
 100  80 100 100  80  60  20 120  60  80 100 100  80  80  60  80  40  60
 100 100  60  20 120 100 100 120  80 100 120  80  80  60 100 100  80 100
 100  80 100  40 100  80 100 100  80 100]

