BC4+Scripted_0
[  0   0  20  20  40  40   0   0  20 160  20  60   0   0   0   0   0  40
  20   0   0  80  20  40  20  60   0   0  20  80  20   0   0   0  20  40
  20  20  20  80   0  40  60   0   0   0  40  60  60   0   0   0  20  20
   0  40  20  60   0   0  20  40  20   0  20   0   0  40   0  80   0  40
   0   0  20   0  60  60  20  20   0   0   0   0  20  20  20 120   0  60
   0  60   0   0  20   0  20  20   0  40]

BC4+Scripted_1
[ 20   0  20   0  40  20  60   0   0  20  20   0  60  20  60  80   0   0
  20   0  20   0   0  40  60   0  20  20   0   0   0   0  20  20   0  20
  20 120  60 100  20   0   0  40  60  20  20   0  20   0  40   0  20   0
   0  60   0  20  20  40   0  80  20  40  20  20  20  40  40  20  60  60
  80  20   0  40  40   0  20   0   0  40 100  20  20  60  20  20  20  60
  40  20   0  40   0   0  80   0  20  20]

