BC4+H_proxy_0
[ 20  80  60  60  60 100  80  80   0 100 100   0 100  80  60  80  40  60
 100 100  40 100  80  80  40  40  80  80  60  60  80 100  40 100  80 100
  80  60 100 100  40  20  80  60  60  20  60  80  20  80  80  20  40  80
  80  60  60  40 100 120  80  60  80  60 100 100  40  80  80  80  80  80
  80  80  80 100 120  80  80  60  80  20  60  80  80  80  60  40  60  60
 120  40  20  80  40  60  60  80  20  40]

BC4+H_proxy_1
[ 80  60 100  80  60  40 100 100 100  80  60 100  40  60 100 100  60 100
 100  60  40  80 100  80 100 120  60 100 100  60  60  40  40  60  80  60
  60 100 100 100  80  80 100  80  40 100 100  80  40 100   0  80 100  80
  80 100  80  80  40  40  20  60  60 120 100 100 100  80  80  20  80 100
  60  60  60  80  80  80 100  60  40  60  80  80  80  60 100 100  60  40
 120  40 100  80 100  60  60   0 100  80]

