BC2+Scripted_0
[ 80 180 140 160  60 140 120 140 120 180 120 120  80 160 180  60 180 100
 120  80 160 180 140 160 160  60 180  80   0 160 120 120 160  40  60 180
 120 140 180  80 180 100  60  20 140 140 180 140 120 120 200 140  80 140
 120 140  80  60  80 120  60 140 160 180 180 140 120  80 100 180 140 120
 180  80 180  80 100 160 180  80 160  60 100 160 100 180 160 120 140 100
 140 160 160 140 160 100 120   0 120 100]

BC2+Scripted_1
[140 120 160 140   0 180 180 120  40  60 140 120 160 120 160 140 120  40
 160 180  20 140 120  80 100 120 140 140 100 180 120 160 140  60 160  40
 180 140 140 140 180 180  40  80 100  80  20 180 140 100 100 120  60 160
 120 160 140 100 180 120 120 160 160 100 140 100 180  80 120 160 120 120
 160 140  80 180 120 120  80 100 140 160 160 140 160 120 140 140 180  80
 120 120 120 140 160 140 140  20 120  80]

