BC2+H_proxy_0
[ 20  80  80  40  80  80  40  80  60  80 100  80  80  80  60 100  40 100
  40 100 100 100  80  60  60 100 120 100  60  40  80 100 100  80  80  60
  40  40 100  80 100  80 100 100  80  60  80  40 100  60  60  80 100  80
  60  60  80  60 100  80  80  60 100 100  80 100  60 100  80 100 100  80
  60  80  80  60  40  80 100  80  80  80  20 100  80  20 100  40  80 100
  80 120 100   0  60  80 100 100 100  80]

BC2+H_proxy_1
[ 80  80 100 100  60  80 100  80  80  80 100  60  80  60 100  60  60  60
  80 100  60  60  60 100  80  80  80 100 100  80  80  80  60  80  60  80
  40 100 100  80 100  60  60  80  20  80  80  80  80  80 100  80 100  60
  60  80 100  60  80 100  60 100 120  80  80  60  80 100 100 100  40  60
 100 100  40  60  60  80  60 100  80 100 120  60 100 100  80  80 120  60
  80 100 120 100  60  40 100 100  60  80]

