BC2+PPO_0
[  0  80  40 100  20 100  60 120  60  80 160 120 120  20  40 140 100  20
 140  80   0 140 120   0 120  20 140 100 120  40   0 100 140 100  40 160
  60   0 140 120  80   0 160 120 120 100  60 140  80  20  40 100 160   0
  20   0  60 100   0  20  40 160 100 140  60  80  60  20  60 160 100  60
   0   0 140  40  60 140  80 120  80  60 140 180  40   0   0  20  60   0
 180 100  40  20  80  20 120 120 120 100]

BC2+PPO_1
[120 120  60   0   0   0  80  20   0  40   0  80  80 100  60  20 100  40
  60  40  20  80   0 120   0   0 140   0  20 140  80   0   0 120 100   0
   0  80   0   0  20 160  40  60 100  20  20  20  80  40   0 100 120  40
   0  20  40 100 100 100   0  20 140   0  20   0 100  20   0  20  40 160
   0   0 100  40  20   0  60   0   0  60  20 100  60 140  80 120 100  40
   0   0  20  60 100  40   0   0  60  40]

