BC3+Scripted_0
[ 20  20   0   0  20  20   0   0   0  20   0   0  60   0   0  20   0   0
  20  40  60  80  20  20  40   0   0  20   0   0  20  20   0   0   0  20
  40   0   0   0  20   0  20  60   0   0  20  20  40  20  40  20  20   0
  20   0   0  20   0   0  20  60   0  20  40   0  20  40   0   0   0  20
  40  40   0   0  80   0  20   0   0   0   0  20  20   0   0   0 100   0
  40  20   0   0  20   0  40   0   0   0]

BC3+Scripted_1
[ 80   0   0  40   0   0  60  20  60 100  20  20 120  60 100  60  20  20
 120  60  20   0  40  20  20  80  60  60   0  20  60  80  80  80  60  20
   0  40  20 100 140  20  20  40  40   0  20  40  40  20  40  20  20  60
  20  20  40  20  60  40  40  40  40  80  20  60  60  20  20   0  20  40
   0  80  20  40  40  40  60  20  40  80  60  60  20  40  40  20   0  20
 100  20  40  20  60  20  80  40  40  20]

