BC3+PPO_0
[ 20   0  40  20  20  20  20  20  20  40   0  20  20   0  40  40   0  20
  40  60  40  20  60   0  40  40  60  20  20   0  60   0  40  40 100  20
  40  20  20   0  80 100   0  40   0  20  20  20  20  60  20  20  40   0
  80   0  20  20  80  20   0  20   0  20   0   0  60  40  80   0  60  60
  20   0   0   0   0  40   0  20  80   0  40  20  20  80   0  40   0   0
   0   0  20  20  60  60  20  20  20   0]

BC3+PPO_1
[ 20   0   0  20   0  20  40   0   0  80  80   0   0   0   0   0   0   0
   0   0  80   0   0   0   0   0   0   0   0   0   0  40  20   0  40  20
  40  60  20   0   0   0   0   0  40   0   0  60   0   0   0  20  20   0
   0  60   0   0   0  40   0  20   0  60  60   0   0  20   0   0  20  40
   0   0  20  20  40   0  20   0   0   0  20  60   0   0  60   0  20   0
  60   0   0  80   0   0  40 140  40   0]

