BC3+H_proxy_0
[ 80  80  80   0  60  60  80  40  20  80  60  80 100  80 100   0  80  60
 100  60  80  40  40  60  80  20  20  20 100 100  80  40  80  80  40 100
  60  40 100  80  60  40   0  40  80  60   0   0  80  80   0 100  80 100
  80  60 100  60  60  80  60  80  60 100 100  80  80 100  60  80  60  60
  80  40   0  60 100  60 100  20 100  60  20 100  60  40  80  40  40  80
  40  80 100  40  40 100 100  80  80  80]

BC3+H_proxy_1
[ 80  20   0   0  40  40  20  80  80  80  40  80  40  60 100  80 100  60
  40  80  80  60   0  60  60  60  80  20  80  40  80  60 100  80  40 100
  80  80  80  80  40  20  60  80  60  60  60  80  80  40  60  60  60  80
  80 100  40  80  60  20  80 100  80  60  40  80  60  60  80  80  60  80
  80 100  40  80  40  80  80  80  40  80   0  80 100  60  20  20  60 100
  40 100  80  80  60  80  60  60  80  80]

