BC1+PPO_0
[ 60  60 140 120  20   0 120  80  80   0  20 100 120 120 120  40 120  60
 120  60  80  40 120   0 100 100  60  80  20 100  80  80 100  80 120  40
  60   0  80 160  40   0 120   0  60 120  60  60 120 100  20  60  80 120
 100  80  20 160 120 120  40 120  40 100  20 100  80  80  60 120  20 160
 140 140  20   0  60 100 100  40 100  20  80  20  40 140  80  20  60  20
 120  80 160  40 100  80  80 120  20 120]

BC1+PPO_1
[140  20   0  20   0 120  80   0   0 100   0  20  80   0 140  20  40  80
  20  40  80  20  60  40 140  80  20  20  40 100   0   0 120 100  60  80
  40   0   0 120   0  20   0  80   0  60 120   0 100   0   0  40  40   0
   0  60  20  20   0  20  20  60  40  20 100   0  20   0  40 120  60   0
   0   0   0   0  20 100  40  40   0   0  60  80  60  80  60   0 100  60
   0  20  20  20 100   0  40   0   0 140]

