BC1+Scripted_0
[180 140 180 140 160 120  80 100 100 100 100 140 120  80  60 100 120 100
 140 120 120  40 160 140  40 120 180 120 200 140 120  80 100 100 120 140
 120 120  60 120 120 180  60 100 160 100 160 180 120 140 140 120 160 100
 160 140 120 120  80  80  60 120 120 120 120 120 100 120 120 100 180  80
 100 120  80 120 160 160  40 100 140 180 140 180 140 140  80 120 120 120
 140 140  80  80 100 100 100 180  80 140]

BC1+Scripted_1
[140 120 140 160 140  60 140 180 140 120 120 180 180 160 140 120  80 100
 120 160 100 100 100 160 100  80 140 100 180 180 180 160 160 140 120 160
 160 140 100 160 160 160 120 180 140 120 140 140 140 100 160 100  80 160
 140 120 120 100 100 160 100 140 140 160 180 120 120 160 120  80 100 140
 160 160 140 140  80  80 140 160 100 120 120 120 140 160 140 160 120 140
  60 160 100 160 140 160 120 120 120 160]

