BC1+H_proxy_0
[100  20  80  60 100  60 100  80  80   0  20  60  80  80 100  40  40  60
  80  80  80 100  80  80 100  60  60 100  80  80  80  80 120 100  20  80
  60 100  40  80  60  40 100  60 100  60  60  60  60  80  60  80 100  80
  80 100  80  80  80 100  80 120  80 100  80  40  80  80  80  80  80  60
  80  80 100  80  80  80  80  80 100  80  40  60  60  60  40  60  60 100
  60  40  80  40  60  80  80  80 100  80]

BC1+H_proxy_1
[ 80 100 100  80  80 100  60  60  60  80 100  80  80  60  80 100 100  80
 100  20   0  80  60  80  40  40  80  80  80 120  80  60 100  80  80  80
  80  80 100 100 100  60  40 100  80  80 100 100  60  80 100  80  60  60
  20  60  80  80 100 100  80  80  80  20  60 100  60  80 100 100  80  80
  60  80  80  60  60  60  80 120  80  80 100 100 100 120  60 100 100  60
  80  80  40  40  60 100  40  40 100  20]

