BC+Scripted_0
[160 120 160 180 180  40 100 180 160 160 160 160 160 140 140 140 120 140
 140 140 140 180  60 180 120 160  80 180 140 160 160 180 160 160 180   0
 120  80 180 180 140 100 160 120 100 100 100 180 140  80 100 140 100 140
 140 140 160 120 120 100 180 140 100 160 180 180 140 160 160 160 120 160
 160 140 160 140 160 160 120 100 160 160 100  80 160 100 160 160 160 200
 140 180 140 120 100 120  40 160  40 100]

BC+Scripted_1
[160 140 100  60 100 100  40 180 120 140 140 160   0 180 140 160   0 160
 160 140 160 160 160 180 120 180 160 160 140 160 160 160 180 100 160 160
 140 180 120 160  80  80 140  60 140 180 160 120 100 140 120 100 140 140
 140 180 120 160 140 180 100 120 160 120 140 160 120 140 160 180 100 180
 140 140 140 160 160 160 160 140 100 160 160 140 140 180 100  60 120 160
 160 100 160 140 160 140 160  80 160 160]

