BC+H_proxy_0
[ 80  80  80 100  40  20 100  60  40  60 100 100 100  60  60 100  60 100
  80  80  80  80  60  80 100 100 120  80  80  40  60  60  60 120 100  60
  60  80  40  80  80  60  80 100 120 100  80 100  40  60  60  80  80  80
  80 100  60 100  80 120  80  80 100  20  40  80  80  20  40 100  60  60
  60 120  40  60  60  60  80  60  60  80  60 120 120  80  20  80  60  60
 100  60 100 120  80  60 100  80  80  80]

BC+H_proxy_1
[ 80  20 100  80 100 100 100 120 100  60  60 100 100  60 100  80  80 100
 120  60  60 120 100  80  80  80  80  60  80  80  80 100 120  80  80  60
  80 100 100  80 100  80  20  80 100 100 100 120 100 100  60  40 100 100
  60 120  60  80 120  80 100 100  20  60 100  40 100 100  60  80  40 100
 100  60 100  80  80 100 100 100 100  80  80  60 100 100  60   0  80  40
  60  80  60  40  60  80 100 100 100  60]

