BC+PPO_0
[  0   0  80  40  20  40  60  20  40  60 100   0  20  20   0 160  60  40
  20  40   0  80  20 160  20   0  40  60 120 100 100  20 100 160  40  20
  20 160  40  80  60  40 160   0  40  60  60  20   0  80 120  20  60   0
  20   0  60  80  80  40 160  40 100   0  40   0   0  20   0  20  40  60
   0  60  80 140  20  20  20  40  60  20  20 140  20  20  60 100   0  60
  20  80  40  20   0 100 180  20 100  40]

BC+PPO_1
[180  40  60  80   0   0  20  80  60  80   0  60   0  80   0   0 160  60
   0   0  20 100  60  60   0  80  40  60  80  60   0   0   0   0   0  40
  20  20   0   0   0   0   0  20   0   0   0  20  20 140  60   0   0  20
 100  80  40   0   0   0   0   0  20   0   0  20 100  60   0  40   0   0
   0   0   0  80   0   0  20   0   0   0   0  20  60  60   0   0 100   0
 100 100   0   0 160   0  40   0  40 140]

